[
  {
    "name": "easy",
    "levels": [
      {
        "level": 1,
        "dimensions": 10,
        "playable": true,
        "map": [
          ["w", "w", "w", "w", "w", "w", "w", "w", "w", "w"],
          ["w", "s", " ", " ", " ", " ", " ", " ", " ", "w"],
          ["w", " ", " ", " ", " ", " ", " ", " ", " ", "w"],
          ["w", " ", " ", " ", " ", " ", " ", " ", " ", "w"],
          ["w", " ", " ", " ", " ", " ", " ", " ", " ", "w"],
          ["w", " ", " ", " ", " ", " ", " ", " ", " ", "w"],
          ["w", " ", " ", " ", " ", " ", " ", " ", " ", "w"],
          ["w", " ", " ", " ", " ", " ", " ", " ", " ", "w"],
          ["w", " ", " ", " ", " ", " ", " ", " ", "e", "w"],
          ["w", "w", "w", "w", "w", "w", "w", "w", "w", "w"]
        ]
      },
      {
        "level": 2,
        "dimensions": 10,
        "playable": false,
        "map": [
          ["w", "w", "w", "w", "w", "w", "w", "w", "w", "w"],
          ["w", "s", "w", " ", " ", " ", "w", "w", " ", "w"],
          ["w", " ", "w", " ", "w", " ", " ", " ", " ", "w"],
          ["w", " ", "w", " ", " ", " ", "w", "w", " ", "w"],
          ["w", " ", "w", " ", "w", " ", " ", " ", " ", "w"],
          ["w", " ", "w", " ", " ", " ", "w", "w", " ", "w"],
          ["w", " ", "w", " ", "w", " ", " ", " ", " ", "w"],
          ["w", " ", "w", " ", " ", " ", "w", "w", " ", "w"],
          ["w", " ", " ", " ", "w", " ", "w", "w", "e", "w"],
          ["w", "w", "w", "w", "w", "w", "w", "w", "w", "w"]
        ]
      },
      {
        "level": 3,
        "dimensions": 10,
        "playable": false,
        "map": [
          ["w", "w", "w", "w", "w", "w", "w", "w", "w", "w"],
          ["w", " ", " ", " ", " ", " ", " ", " ", " ", "w"],
          ["w", " ", " ", " ", " ", " ", " ", " ", " ", "w"],
          ["w", " ", " ", " ", " ", " ", " ", " ", " ", "w"],
          ["w", " ", " ", " ", " ", " ", " ", " ", " ", "w"],
          ["w", " ", " ", " ", " ", " ", " ", " ", " ", "w"],
          ["w", " ", " ", " ", " ", " ", " ", " ", " ", "w"],
          ["w", " ", " ", " ", " ", " ", " ", " ", " ", "w"],
          ["w", " ", " ", " ", " ", " ", " ", " ", " ", "w"],
          ["w", "w", "w", "w", "w", "w", "w", "w", "w", "w"]
        ]
      }
    ]
  }
]
